
  # # # # # # # # # # # # # # # # # #
  # @ . . # . . . . . . . . . . . . #
  # . # . # # # . . . . . . . . . . #
  # . . . # # # . r . . # . . . . . #
  # . . . # # # . . . . # . . . . . #
  # . . . + . . . . . . # . . . . . #
  # # # # # # # # # # # # # # # # # #
