
  # # # # # # # # # # # # # # # # # #
  # @ . . # . . . . . . . . . . . . #
  # . # . # # # . . . . . . . . . . #
  # . . . # # # . r . . # . . . . . #
  # . r . # # # . . . . # . . . . . #
  # . . . + . . . . . . # . . . . . #
  # + # # # # # # # # # # # # # # # #
  # . . . . . . . . . . . . . . . . #
  # . . . . . . . . . . . . . . . . #
  # . . ! . . . . . . . . . . . . . #
  # . . . . . . . . . . . . . . . . #
  # . . . . . . . . # . . . . . . . #
  # . . . . . . . . . . . . . . . . #
  # . . . . . . . . . . . . . . . . #
  # . . . . . . . . . . . . . . . . #
  # . . . . . . . . . . . . . . . . #
  # . . . . . . . . . . . . . . . . #
  # # # # # # # # # # # # # # # # # #
