
  # # # # # # # # # # #
  # . . . . . . . . . #
  # . . @ . . . . . . #
  # . . . . . . . . . #
  # # # # # + # # # # #
  # . . . . . . . . . #
  # . . . . . . . . . #
  # . . . . . . r . . #
  # . . . . . . . . . #
  # . . . . . . . . . #
  # # # # # # # # # # #
