
  # # # # # # # # # # # # # # # # # #
  # @ . . # . . . . . . . . . . . . #
  # . # . # # # . . . . . . . . . . #
  # . . . # # # . r . . # . . . . . #
  # . ɑ . # # # . . . . # . . . . . #
  # . . . + . . . . . . # . . . . . #
  # + # # # # # # # # # # # # # # # #
  # . . . . . . . . . . . . . . . . #
  # . . . . . . . . . . . . . . . . #
  # . . β . . . . . . . . . . . . . #
  # . . . . . . . . . . . . . . . . #
  # . . . . . . . . # . . . . . . . #
  # . . . . . . . . . . . . . . . . #
  # . . . . . . . . . . . . . . . . #
  # . . . . . . . . . . . . . ɣ . . #
  # . . . . . . . . . . . . . . . . #
  # . . . . . . . . . . . . . . . . #
  # # # # # # # # # # # # # # # # # #

== key ==
@: player
 : chasm
.: ground
#: wall
+: door
r: rat
ɑ: torch
β: parchment
ɣ: map
