
  # # # # # # # # # # #
  # . . . . . . . . . #
  # . . . @ . . . . . #
  # . . . . . . . . . #
  # . . . . . . . . . #
  # . . . . . . . . . #
  # . . . . . . . . . #
  # . . . . . . @ . . #
  # . . . . . . . . . #
  # . . . . . . . . . #
  # # # # # # # # # # #
